####################################################################################
#..................................................................................#
#..####.....#.....#####...####.....................................................#
#..#..#....#.#....#...#...#........................................................#
#..#..#...#####...#...#...#........................................................#
#..#..#..#.....#..#...#...####......................######.........................#
#....................................#####...#####..#..............................#
#....................................#......#....#..######.........................#
#....................................#.....#######..#..............................#
#....................................#.....#.....#..######.........................#
#..................................................................................#
#...............####......................######...................................#
#..####..#####..#......#######.....#......#.........#.......#......................#
#..#..#..#...#..####...#..#..#....#.#.....######....#####...#......................#
#..#..#..#####..#......#######...#####....#....#....#...#...#......................#
#..#..#..#......####......#.....#.....#...######....#####...#......................#
#..................................................................................#
#..................................................................................#
#..................................................................................#
#..................................................................................#
#..................................................................................#
#..................................................................................#
#..................................................................................#
#..................................................................................#
####################################################################################
