####################################################################################
#..................................................................................#
#..####.....#.....#####............................................................#
#..#..#....#.#....#.......#........................................................#
#..#..#...#####...#...#...#........................................................#
#..#..#..#.....#..#...#............................................................#
#....................................#.......#####..#..............................#
#....................................#......#....#..######.........................#
#..........................................#....##..#..............................#
#..........................................#.....#..######.........................#
#..................................................................................#
#...............####...............................................................#
#..........................####DDDD########........................................#
#..#..#..#...#..####.......#..............#.........#####...#......................#
#..#..#.........#......#####..............#....#....#...#...#......................#
#..#..#..#.................#..............######....#####...#......................#
#..........................#......S.......#........................................#
#..........................#..............#........................................#
#..........................#..............#........................................#
#..........................################........................................#
#..................................................................................#
#..................................................................................#
#..................................................................................#
#..................................................................................#
####################################################################################
