####################################################################################
#..................................................................................#
#..####.....#.....#####............................................................#
#..#..#....#.#....#.......#........................................................#
#..#..#...#####...#...#...#........................................................#
#..#..#..#.....#..#...#............................................................#
#....................................#.......#####..#..............................#
#....................................#......#....#..######.........................#
#..........................................#....##..#..............................#
#..........................................#.....#..######.........................#
#..................................................................................#
#...............####...............................................................#
#..####..#####..#......#######.....#......#.........#.......#......................#
#..#..#..#...#..####...#..#..#....#.#...............#####...#......................#
#..#..#.........#......#######...#####....#....#....#...#...#......................#
#..#..#..#................#.....#.....#...######....#####...#......................#
#..................................................................................#
#..................................................................................#
#..................................................................................#
#..................................................................................#
#..................................................................................#
#..................................................................................#
#..................................................................................#
#..................................................................................#
####################################################################################
